at-d-none = at-d-non
at-inline = at-inl
at-inline-block = at-inl-blk
at-block = at-blk
at-table = at-tbl
at-table-row = at-tbl-row
at-table-cell = at-tbl-cel
at-flex = at-flx
at-inline-flex = at-inl-flx
at-print-none = at-prt-non
at-print-inline = at-prt-inl
at-print-inline-block = at-prt-inl-blk
at-print-inline-block = at-prt-inl-blk
at-print-block = at-prt-blk
at-print-table = at-prt-tbl
at-print-table-row = at-prt-tbl-row
at-print-table-cell = at-prt-tbl-cel
at-print-flex = at-prt-flx
at-print-inline-flex = at-prt-inl-flx

at-flex-row = at-flx-row
at-flex-row-reverse = at-flx-row-rev
at-flex-column = at-flx-col
at-flex-column-reverse = at-flx-col-rev
at-flex-wrap = at-flx-wrp
at-flex-nowrap = at-flx-nowrp
at-flex-wrap-reverse = at-flx-wrp-rev
at-flex-fill = at-flx-fil
at-flex-grow = at-flx-grw
at-flex-shrink = at-flx-srnk

at-justify-content-start = at-jfy-cont-st
at-justify-content-end = at-jfy-cont-end
at-justify-content-center = at-jfy-cont-ctr
at-justify-content-between = at-jfy-cont-btw
at-justify-content-around = at-jfy-cont-ard
at-justify-content-evenly = at-jfy-cont-evnly

at-align-items-start = at-al-itm-st
at-align-items-end = at-al-itm-end
at-align-items-center = at-al-itm-ctr
at-align-items-baseline = at-al-itm-bsln
at-align-items-stretch = at-al-itm-strh

at-align-content-start = at-al-cont-st
at-align-content-end = at-al-cont-end
at-align-content-center = at-al-cont-ctr
at-align-content-between = at-al-cont-btw
at-align-content-around = at-al-cont-ard
at-align-content-stretch = at-al-cont-strh

at-align-self-auto = at-al-slf-auto
at-align-self-start = at-al-slf-st
at-align-self-end = at-al-slf-end
at-align-self-center = at-al-slf-ctr
at-align-self-baseline = at-al-slf-bsln
at-align-self-stretch = at-al-slf-strh

at-container-fluid = at-ctnr-fld
at-container-min = at-ctnr-min
at-offset = at-ofst
at-order = at-ord