1. Dont use shortname for 3 or less letters except top, bottom, left, right or converting in the single letter shortname

al - align
acc - accordion
acl - accent-color
atch - attachment
ani - animation

ard - around
attrib - attributes
auto - auto/automatic
b - bottom
bdr - border
br - bottom right
bl - bottom left
beh - behavior
blk - block
bg - background
bs - base
bsln - baseline
btn - button
btw - between
box - box
cpt - caption
cel - cell
cl - color
col -column
cont -content
cb -combobox

ct - caret
ctnr - container
ctrl - control
ctr - center
cur - cursor
cust- custom
d - display
dt - data
dec - decoration
dft  - default or Def?
dir - direction
ed - editor
ev - events
evn - even
end - end
evnly - evenly
ext - external
fil - fill
fig - figure
fl - filter
flx - flex
flt - floating
fld - fluid
fnt - font
fam - family
grw - grow 
grd - gradient 
grp - group 
gtr - gutter
h - height
idx - index
ind - indicator
img - image
inl - inline
itm - item
itms - items
jfy - justify
lg - large device
ls - list
lnk  - link
ltr - letter
lbl - label
ln - line
l - left
lyt - layout
md - medium device
mod - mod
mode - mode
mtdt - meta-data
m - margin
min - min
msk - mask
max - max
non - none
opa - opacity
ofst - offset
org - origin
ord - order
outl  - outline
ov - over
ovf - overflow
p - padding
pnl - panel
ppv - perspective
pos - position
prt - print
ptr - pointer
rpt - repeat
refl - reflect
rst - reset

r - right
rad - radius
rev - reverse
resp - responsive
row - row
scr - scroll
sd - side
sdw - shadow
shp - shape
sec - section
sep - separated
slf - self
sz - size
szg - sizing
sm - small-device
sp - space
spg - spacing
srnk  - shrink
st - start
str - string
strh - stretch
sty - style
tbl - table
tog - toggle
t - top
tl - top-left
tr - top-right
trs - transition
ttl - title
ttip - Tooltip
txt - text
tf - transform
typ - typography
vis - visibility
vid - video
vrt - vertical
w - width
wt - weight
wrd - word
wrp - wrap
xl - x-large-device
xs - x-small-device
xxl - xx-large-device